.....................................
.....................................
..............GGGG...................
.....................................
........GGGGGG......GG...............
..........S.........DD...............
..................SGDDGG.............
GGGS..............SDDDDDGS....F......
DDD......................GGGGGGGGGGGG
....S....................DDDDDDDDDDDD
...GGGGGGGGG.............DDDDDDDDDDDD
P........................DDDDDDDDDDDD
GGGGGGGGGGGGGGGGGGGGGGGGGDDDDDDDDDDDD
DDDDDDDDDDDDDDDDDDDDDDDDDDDDDDDDDDDDD
DDDDDDDDDDDDDDDDDDDDDDDDDDDDDDDDDDDDD
DDDDDDDDDDDDDDDDDDDDDDDDDDDDDDDDDDDDD
DDDDDDDDDDDDDDDDDDDDDDDDDDDDDDDDDDDDD
DDDDDDDDDDDDDDDDDDDDDDDDDDDDDDDDDDDDD
DDDDDDDDDDDDDDDDDDDDDDDDDDDDDDDDDDDDD
DDDDDDDDDDDDDDDDDDDDDDDDDDDDDDDDDDDDD