.....................................
.....................................
..............GGGG...................
.....................................
........GGGGGG......GG...............
..........S.........DD...............
..................SGDDGG.............
GG................SDDDDDGS....F......
DD.......................GGGGGGGGGGGG
....S..Z.................DDDDDDDDDDDD
...GGGGGGGGG.............DCCCCCCCCCCC
P.....................Z..DCCCCCCCCCCC
GGGGGGGGGGGGGGGGGGGGGGGGGDCCCCCCCCCCC
DDDDDDDDDDDDDDDDDDDDDDDDDDCCCCCCCCCCC
CCCCCCCCCCCCCCCCCCCCCCCCCCCCCCCCCCCCC
CCCCCCCCCCCCCCCCCCCCCCCCCCCCCCCCCCCCC
CCCCCCCCCCCCCCCCCCCCCCCCCCCCCCCCCCCCC
CCCCCCCCCCCCCCCCCCCCCCCCCCCCCCCCCCCCC
CCCCCCCCCCCCCCCCCCCCCCCCCCCCCCCCCCCCC
CCCCCCCCCCCCCCCCCCCCCCCCCCCCCCCCCCCCC