.....................................
.....................................
..................F..................
..............GGGGG..................
..............DDDDD..................
........GGGGG........................
........DDDDD........................
GGGG.................................
DDDD....GGGGGGG......................
........DDDDDDD.....G....GGGGG.......
....................D....DDDDD.......
.........................DDDDD...GGGG
P.........S......................DDDD
GGGGGGGGGGGGGGGGGGGGGGGGGGGGGGGGGDDDD
DDDDDDDDDDDDDDDDDDDDDDDDDDDDDDDDDCCCC
CCCCCCCCCCCCCCCCCCCCCCCCCCCCCCCCCCCCC
CCCCCCCCCCCCCCCCCCCCCCCCCCCCCCCCCCCCC
CCCCCCCCCCCCCCCCCCCCCCCCCCCCCCCCCCCCC
CCCCCCCCCCCCCCCCCCCCCCCCCCCCCCCCCCCCC
CCCCCCCCCCCCCCCCCCCCCCCCCCCCCCCCCCCCC